D U U U U U U U U U D D D D D
D U U U U U U U U U D U U U U
D U U U U U U U U U D U U U U
D U U U U U U U U U D U U U U
D U U U U U U U U U D U U U U
D D U U U U U U U U D U U U U
U D U U U U U U U U D U U U U
U D D D D U U U U U D U U U U
U U U U D U U U U U D U U U U
U U U U D D D D D D D U U U U